background_1
YE,YE,YE,YE,YE,YE,YE,YE,YE,YE,YE,YE,YE,YE
MA,MA,MA,MA,MA,MA,MA,MA,MA,MA,MA,MA,MA,MA
BL,BL,BL,BL,BL,BL,BL,BL,BL,BL,BL,BL,BL,BL
RE,RE,RE,RE,RE,RE,RE,RE,RE,RE,RE,RE,RE,RE
GR,GR,GR,GR,GR,GR,GR,GR,GR,GR,GR,GR,GR,GR
CY,CY,CY,CY,CY,CY,CY,CY,CY,CY,CY,CY,CY,CY
OR,OR,OR,OR,OR,OR,OR,OR,OR,OR,OR,OR,OR,OR
WH,WH,WH[L],WH[E],WH[C],WH[S],WH[D],WH[P],WH,WH,WH,WH,WH,WH