background_2
RE,BL,BL,BL,BL,BL,BL,BL,BL,BL,BL,BL,BL,BL
RE,RE,BL,BL,BL,BL,BL,BL,BL,BL,BL,BL,BL,BL
RE,RE,RE,WH,WH,WH,WH,WH,WH,WH,WH,WH,WH,WH
RE,RE,RE,RE,WH,WH,WH,WH,WH,WH,WH,WH,WH,WH
RE,RE,RE,RE,WH,WH,WH,WH,WH,WH,WH,WH,WH,WH
RE,RE,RE,WH,WH,WH,WH,WH,WH,WH,WH,WH,WH,WH
RE,RE,GR,GR,GR,GR,GR,GR,GR,GR,GR,GR,GR,GR
RE,GR,GR[S],GR[S],GR[S],GR[S],GR[S],GR[S],GR[S],GR[S],GR[S],GR[S],GR,GR