background_1
YE,YE,YE,YE,YE,YE,YE,YE,YE,YE,YE,YE,YE,YE
MA,MA[P],MA[L],MA[S],MA,MA,MA,MA,MA,MA,MA[P],MA[L],MA[S],MA
BL,BL,BL,BL,BL,BL,BL,BL,BL,BL,BL,BL,BL,BL
RE,RE,RE,RE,RE,RE,RE,RE,RE,RE,RE,RE,RE,RE
GR,GR,GR,GR,GR,GR,GR,GR,GR,GR,GR,GR,GR,GR
CY,CY,CY,CY,CY,CY,CY,CY,CY,CY,CY,CY,CY,CY
OR,OR,OR,OR,OR,OR,OR,OR,OR,OR,OR,OR,OR,OR
WH[E],WH[L],WH[S],WH,WH,WH,WH[D],WH[D],WH,WH,WH,WH[S],WH[L],WH[E]